Fondly  - С любовью
put smth in  - вставлять
vacuum cleaner  - пылесос
put up with  - терпеть
electric light  - электрический свет
manage  - справляться
turn up  - появляться
take up  - начать заниматься
sort out  - рассортировать
rough  - набрасывать
put in  - проводить время
pass away  - уйти в мир иной
make into  - превращать
give away  - отдавать
do up  - упаковывать
cut back  - возвращаться
consume  - потреблять
charge up  - заряжать
go off  - портиться
live off  - жить за счёт
make something up  - сочинять что-то
move back  - отъезжать
put something in  - вставлять
get by with  - обходиться
soap operas  - мыльные оперы
chat shows  - ток-шоу
drama series  - драматический сериал
documentaries  - документальные фильмы
cartoons  - мультфильмы
quiz shows  - шоу викторины
satellite tv  - спутниковое телевидение
be over  - заканчиваться
go out with  - встречаться c
hurry up  - торопиться
turn back  - возвращаться
warm up  - разминаться
plug in  - включать
fill in  - замещать
turn down  - уменьшать
look out  - быть настороже
look up  - искать


sort out  - улаживать
predictable  - предсказуемый
crime writer  - писатель-криминалист
detective novel  - детективный роман
reckoning  - подсчёт
business associate  - бизнес-партнер
murder mystery  - детективный сюжет
intend  - намереваться
evidence  - доказательство
scientific  - научный
foggy  - туманный
brutal  - жестокий
inhabitant  - житель
amateur  - любительский
merchant  - торговец
violence  - насилие
suspect  - предполагать
confess  - сознаваться
ripper  - потрошитель
innocent  - наивный
fictional  - вымышленный
enquiry  - наведение справок
detection  - обнаружение
murder mystery  - детективный сюжет
terrorize  - вселять страх
confess to murders  - признаваться в убийствах
prove the identity  - доказывать личность
dismantling  - демонтаж
witness  - свидетель
commit  - совершать
fall over  - отказывать
achieve  - достигать
desperate  - отчаявшийся
convince  - убеждать
recipient  - получатель
overuse  - злоупотреблять
ammunition  - боеприпасы
nosy  - любопытный
cotton on  - усваивать
quell  - подавлять
ruthlessly  - безжалостно
salacious  - непристойный
rendezvous  - встреча
berth  - причал
lingering  - затяжной
demeanor  - поведение
stealth  - скрытность
be keen on  - любить делать
trouser  - штанина
speak out  - высказывать мнение
reconcile  - примирить
arrogance  - высокомерие
fairness  - честность
cellar  - подвал
lung  - лёгкое
invention  - выдумка
capture  - фиксировать
omit  - пропускать
marital  - брачный
refugee  - беженец
unbearable  - невыносимый
insult  - оскорбление
tend  - иметь склонность
justice  - справедливость
overall  - общий
poverty  - нищета
objective  - объективный
film crew  - съёмочная группа
inspire  - вдохновлять
breathtaking  - захватывающий
out-of-date  - устаревший
reduction  - снижение
see smb around  - увидеться
steady  - постоянный
improvise  - импровизировать
analytical mind  - аналитический ум
do complex calculations  - делать сложные вычисления
suit one’s personality  - подходить чьей-то личности
spatial sense  - чувство дистанции
pretend  - притворяться
whereas  - тогда как
chase  - преследовать
benefit  - выигрывать
conduct research  - проводить исследование
encourage  - поощрять
favour  - любезность
tap  - кран
intimate  - близкий
acquaintance  - знакомство
detention  - оставление после уроков
play truant  - прогуливать школу
reunion  - воссоединение
convent school  - монастырская школа
arrange  - договариваться
one-storey (house)  - одноэтажный
be surrounded by  - быть окруженным
mention  - упоминать
spacious  - просторный
on the outskirts  - на окраине
household chores  - домашние обязанности
I am fully aware that  - я прекрасно понимаю, что
what I would also like to mention is  - ещё мне бы хотелось сказать о
it strikes me that  - у меня такое впечатление, что
it is a burning question…  - очень остро стоит вопрос о
people have always thought  - люди всегда считали
besides  - кроме того
however  - однако
consequently  - следовательно
as a matter of fact  - Собственно говоря
in spite of  - несмотря на
optional  - необязательный
rebel  - мятежник
oxygen  - кислород
hydrogen  - водород
notice board  - доска объявлений
give in  - сдаваться
be involved  - быть сложным
spreadsheets  - таблицы
interrogate  - допрашивать
term  - срок
timetable  - график
headteacher  - директор школы
revise  - корректировать
take an exam  - сдавать экзамен
do up one’s coat  - застёгивать пальто
slightly  - немного
canteen  - столовая
interfere  - вмешиваться
behaviour  - поведение
significant  - значительный
towards  - по направлению к
thrilled  - (радостно) взволнованный
properly  - прилично, как следует
take up  - начать заниматься
improve  - улучшать
determined  - решительный
advice  - совет


tight  - обтягивающий
surveillance  - слежка
physical appearance  - внешний вид
wrinkles  - морщины
movement  - движение
alter  - изменять
make an effort  - прилагать усилия
stubble  - щетина
bulb  - луковица
keen  - проницательный
hideous  - ужасный
vain  - самовлюбленный
lush  - пышный
marshland  - болотистая местность
so that  - для того чтобы
sightsee  - осмотреть достопримечательности
sacred  - священный
superstition  - суеверие
upright  - вертикальный
grunt  - хрюканье
rural  - сельский
treat  - относиться
conform  - приспосабливаться
rather  - наоборот
concern  - затрагивать
look down on  - смотреть свысока
gesture  - поступок
inappropriate  - неуместный
offend  - обижать
obligatory  - обязательный
particularly  - чрезвычайно
custom  - обычай
weak  - слабый
presence  - присутствие
cause  - быть причиной
advance  - продвижение
drive to distraction  - сводить с ума
seat belt  - ремень безопасности
rush hour  - час пик
pedestrian area  - пешеходная зона
air pollution  - загрязнение атмосферы земли
taxi rank  - стоянка такси
road works  - дорожные работы
cycle lane  - велодорожка
be distracted by  - отвлекаться на
sled  - сани
car-ferry  - автомобильно-железнодорожный паром
whole  - целый
security  - безопасность
service station  - станция технического обслуживания
ferry  - паром
scenery  - пейзаж
destination  - место назначения
disadvantaged  - обделенный
swing  - взмах
wild  - необузданный
communal  - совместный
afford  - позволить себе
apart from  - помимо
belongings  - имущество
set up  - создавать
give up  - сдаться
give away  - отдавать
wealthy  - состоятельный
discard  - избавляться от
throw away  - растрачивать
shop till  - кассовый аппарат розничной торговли
affect the personality  - влиять на личность
get the top jobs  - получить высокие посты
share something with somebody  - разделять
have common sense  - трезво мыслить
competitive  - стремящийся победить
influence other people  - влиять на других (людей)
trait  - особенность
imaginative  - оригинальный
unreliable  - ненадёжный
extrovert  - экстраверт
bad-tempered  - раздражительный
charming  - очаровательный
manipulative  - манипулирующий
insensitive  - невосприимчивый
self-confident  - уверенный в себе
independent  - независимый
ambitious  - амбициозный
mean  - подлый
jealous  - завистливый, ревнивый
jealous  - ревнивый
blame  - обвинять
through  - не желающий иметь ничего общего с
astray  - заблудившийся
ash  - пепел
thrive  - преуспевать
pinch  - щипать
substitute  - замена
make up  - помириться
age gap  - разница в возрасте
insecure  - неуверенный в себе
affectionate  - нежный
bring up  - воспитывать
brother-in-law  - деверь
evidence  - доказательство
arrangement  - договорённость
intention  - замысел
prediction  - предсказание
conceal  - скрывать
stab  - колоть
torture  - истязание
bricklayer  - каменщик
insight  - проницательность
scorch  - опалять
immerse  - погружать
laid-back  - непринужденный
booze  - выпивка
superb  - великолепный
suburb  - пригород
banksia  - банксия
temporary  - временный
ancient  - древний
loaf  - буханка
conclusion  - умозаключение
squint  - косить глазами
portray  - изображать
soot  - сажа
infrared  - инфракрасный
discrepancy  - разногласие
depict  - изображать
resemblance  - сходство
despite  - несмотря на
waist  - талия
animate  - оживлять
apparently  - по всей видимости
previously  - прежде
accomplice  - сообщник
forgery  - подделка
disreputable  - с плохой репутацией
austere  - аскетичный
inherit  - унаследовать
genuine  - подлинный
lucrative  - прибыльный
striking  - изумительный
pre-eminently  - преимущественно
scam  - афера
authenticate  - устанавливать подлинность
forgery  - подделывание
artist  - художник
enormous  - гигантский
undated  - недатированный
authenticate  - удостоверять
mother-in-law  - тёща, свекровь
demand  - требование
appropriate  - подходящий
entertain  - развлекать
equipment  - оборудование
reliable  - надёжный
entertaining  - развлекательный
psychiatrist  - психиатр
motivate  - побуждать
hairdresser  - парикмахер
host family  - принимающая семья
descendant  - происходящий
ancestor  - предок
prosperous  - зажиточный
foster  - приёмный
adoptive  - приемный
tight-knit  - дружный
immediate family  - ближайшие родственники
well-off  - состоятельный
nuclear family  - полная семья
extended family  - расширенная семья
sanctuary  - заповедник
hunch over  - сутулиться
dedicate  - посвящать
nib  - кончик пера
zany  - идиотский
branch out  - ветвиться
sketchbook  - альбом с набросками
collaboration  - сотрудничество
quill  - перо для письма
line drawing  - рисунок карандашом
benevolent  - доброжелательный
touching  - трогательный
solitude  - одиночество
vibrant  - энергичный
attitude  - отношение
guerilla  - партизан
rubbish bin  - мусорный контейнер
relative  - относительный
destroy  - разрушать
force  - заставлять
worth  - стоимость
mindless  - безмозглый
market value  - рыночная стоимость
replica  - точная копия
stunt  - трюк
install  - устанавливать
elusive  - неуловимый
surreal  - сюрреалистический
installation  - установка
praise  - хвалить
kite  - парить
insist  - настаивать
consider  - считать
particular  - особенный
fur  - мех
peanut  - арахис
leather  - кожа
cot  - детская кроватка
prohibit  - запрещать
cricket  - крикет
rugby  - регби
sailing  - парусный спорт
although  - хотя
compete against sb  - соревноваться с кем-либо
divine  - божественный
disgrace  - позор
fencing sword  - шпага для спортивного фехтования
fencing  - фехтование
cutlery  - столовые приборы
prawn  - креветка
cottage cheese  - прессованный творог
tender  - мягкий
tough  - жёсткий
peel  - кожура
fibre  - клетчатка
disease  - заболевание
harm  - наносить ущерб
lettuce  - салат
get fatter  - толстеть
enjoy a variety of foods  - есть разнообразную пищу
eat out  - есть вне дома
portion  - часть
dish  - блюдо
follow a diet  - придерживаться диеты
heat up  - подогревать
have a proper meal  - правильно питаться
wholemeal bread  - цельнозерновой хлеб
stew  - блюдо из тушёного мяса или рыбы
addicted  - пристрастившийся
cuisine  - кухня
increasing  - увеличивающийся
newcomer  - новичок
